XXXXXXXXXXXXXXXXXXXXXXXXXXXXXXXXXXXXXXXXXXXXXXXXXXXXXXXXXX
      XXXXXXXXX     XXXXXXXXXXXXXXX   XXXXXXXXXXXXXXXXXXXX
XXXXX XXXXXXX   XXX XXXXXXXXXX          XXXXX      XXXXXXX
XXXXX XXXXXXXXX XXX X   XXXXXX XXXXXXXX XXXXX XXXX XXXXXXX
XX          XXX XXX XXX XXXXXX XXXXXXXX XXXXX XXXX XXXXXXX
XXXXXXXXXXX XXX XXX XXX        XXXXXXXX    XXX XXX XXXXXXX
XXXXXXXXXXX XXX XXX XXX XXXXXXXXX       XX XXX     XXXXXXX
XXXXXXXXXXX XXX XXX     XXXX XXXXXXX XXXXX XXXXXXX XXXXXXX
XXXX        XXX XXXXXXX XX X XXXXXXX XXXXX         XXXXXXX
XXXX XXXXXX XXX XXXXXXX XX X         XXXXXXXXXXXXXXXXXXXXX
XXXX XXXXXXXXXX XXXXXXX XX X XXXXXXX XXXXXXXXXXXXXXXXXXXXX
XXXX XXXXXXXXXX XXXXXXX XX   XXXXXXXXXXXXXXXXXXXXXXXXXXXXX
X               XXXXXXX XXXXXXXXXXXXXXXXXXXXXXXXXX        
XXXX XXXX XXXXXXXXXXXXX XXX                        XXXXXXX
XX   XXXX XXXXXXXXXXXXX     XXXXXXXXXXXXXXXXXXXXXXXXXXXXXX
XXXXXXXXX XXXXXXXXXXXXXXXXXXXXXXXXXXXXXXXXXXXXXXXXXXXXXXXX
XXXXXXXXX XXXXXXXXXXXXXXXXXXXXXXXX        XXXXXXXXXXXXXXXX
XXXXXXXXX                     XXXXXXXXXXX XXXXXXXXXXXXXXXX
XXXXXXXXXXXXXXXX XXXXXXXXXXXX             XXXXXXXXXXXXXXXX
XXXXXXXXXXXXXXXX XXXXXXXXXXXX XXXXXXXXXXXXXXXXXXXXXXXXXXXX
XXXXXXXXXXXXXXXXXXXXXXXXXXXXXXXXXXXXXXXXXXXXXXXXXXXXXXXXXX
